222222222222222220000000000000000000000000000000000000000000000000000000
222222222222222222000000000000000000000000000000000000000000000000000000
111111111111111112200000000000000000000000000000000000000000000000000000
111111111111111111220000000000000000000000000000000000000000000000000000
111111111111111111122000000000000000000000000000000222222222222222222222
111111111111111111112200000000000000000000000000002111111111111111111111
111111111111111111111220000000000000000000000000021111111111111111111111
111111111111111111111122000000000000000000000000211111111110000000000000
111111111111111111111111222222222222222222222222111111111110000000000000
111111111111111111111111111111111111111111111111111111111110000000000000
111111111111111111111111111111111111111111111111111111111110000000000000
111111111111111111111111111111111111111111111111111111111111111111111111
111111111111111111111111111111111111111111111111111111111111111111111111
111111111111111111111111111111111111111111111111111111111111111111111111
111111111111111111111111111111111111111111111111111111111111111111111111
111111111111111111111111111111111111111111111111111111111111111111111111
