000000000000000000000000000000000000000000000000000000
000000000000000000000000000000000000000000000000000000
000000000000000000000000000000000000000000000000000000
000000000000000000000000000000222222222222220000000000
000000022222000000000000000000000000000000000000000000
000000000000000000000000030000000000000000000002222222
220000000000000002200000222000000000000000000000000000
112222222222222221100002211200000000000000002200000000
111111111111111111100001111100000000022220000000000000
111111111111111111100000110000000000000000000000000000
111111111111111111100000100000000000000000022222000000
111111111111111111100000100000000000000000000000000000
111111111111111111100000000000000000000000000000000000